xxxxxxxxxxxxxxxxxxxxxx
x____________________x
x____________________x
x___2____x___________x
x________x___________x
x________x______1____x
x________x___________x
x________x___________x
x________1________x__x
x________________px__x
x_______________xxx__x
x____________________x
xxxxxxxxxxxxxxxxxxxxex